###########
#*********#
#*********#
#*********#
###########